11111111111111111111
10000000000110000001
10000000000110011001
1000P000000111111001
10000000000110000001
1000000000011C000001
10000000000000000001
10000000000000000001
10000000000000000001
11111C11111100000001
10000000000100000001
10000000000100000001
10000000001000000001
10000000001000000001
1000000000000000C001
10000000011100000001
1000C000010100111101
100000000101111CC101
100000000000000CC1E1
11111111111111111111
