11111111111111111111
10000000000110000001
10000000000110011001
1000P000000000000001
10000000000000000001
1000000000000C000001
10000000000000000001
10000000000000000001
10000000000000000001
10C00000000000000001
10000000000000000001
10000000000000000001
10000000000000000001
10000000000000000001
1000000000000000C001
10000000000000000001
1000C000000000111101
100000000001111CC111
100000000000000CC1E1
10000000000000000001
11111111111111111111
