11111111111111111111
1C000000000000000001
1C000P00000000000001
1C000D000000000CCCC1
1C000000000D00000001
1C00E000000000000001
11111111111111111111
