11111111111111111111
1C00000000000000D001
1C000P00000000000001
1C0000000000000CCCC1
1C000000000000000001
1C0000000000000000E1
11111111111111111111
