111111
10P001
100CC1
100001
1000C1
111111
