111111111111111111111
100000000000000000001
100000000000000000001
1000P0000000000000001
100000000000000000001
1000000000000C0000001
100000000000000000001
100000000000000000001
100000000000000000001
10C000000000000000001
100000000000000000001
100000000000000000001
100000000000000000001
100000000000000000001
10000000000000000C001
100000000000000000001
1000C0000000000000001
100000000000000000001
1000000000000000000E1
111111111111111111111
