11111111111111111111
10000000000000000001
10000000000000000001
10000000000000000001
10000P00000000000001
1000000000000C000001
10000000000000000001
10000000000000000001
10000000000000011111
10C00000000000010001
10000000000000010001
10000000000000011101
10000000000000000001
10000000000000000001
1000000000000000C001
10000000000000000001
1000C000001111100001
10000000001000000001
100000000010000000E1
10000000001000000001
11111111111111111111
