111111111111111111111
1C000000000000000D001
1C000P0000000000D0D01
1C00000000000000CCCC1
1C00000D0D00000000001
1C0000000000000000001
1C0000000000000000001
1C0000000000000000001
1C00000000D0000000001
1C00000D0000000000001
1C000000D000000000D01
1C00000000000000000E1
111111111111111111111
