11111111111111111111
1C00000000000000D001
1C000P00000000100001
1C0000000000001CCCC1
1C00000DDDD111111111
1C0000000000000000E1
11111111111111111111
